,title,published,view_count,like_count,dislike_count,comment_count,title_length,reactions
0,"Protect The Lamborghini, Keep It!",2024-03-16T16:00:00Z,6749859,914733,0,41062,33,955795
1,I Survived 7 Days In An Abandoned City,2024-03-02T17:00:00Z,135090442,4933077,0,194719,38,5127796
2,Unboxing My 200M Subscriber Play Button,2024-02-29T17:00:00Z,76723681,6396829,0,29972,39,6426801
3,I Filled Chandler‚Äôs Car With Feastables,2024-02-27T18:00:01Z,83609985,5220483,0,12479,39,5232962
4,"Buy Feastables, Win $10,000",2024-02-17T19:00:01Z,106676025,6876682,0,15900,27,6892582
5,"Face Your Biggest Fear To Win $800,000",2024-02-10T17:00:00Z,167812628,5062765,0,226318,38,5289083
6,"$1 vs $250,000,000 Private Island!",2024-01-27T17:00:00Z,153947225,4685842,0,101351,34,4787193
7,"Protect $500,000 Keep It!",2024-01-13T17:00:00Z,118871707,4206264,0,76376,25,4282640
8,I Spent 7 Days In Solitary Confinement,2023-12-30T17:00:03Z,137233935,4399086,0,81262,38,4480348
9,I Rescued 100 Abandoned Dogs!,2023-12-23T17:00:00Z,140017126,5110749,0,96399,29,5207148
10,"Survive 100 Days Trapped, Win $500,000",2023-12-16T17:00:01Z,197364541,5220026,0,85827,38,5305853
11,"Feeding A Dog $1 vs $10,000 Steak",2023-12-14T18:00:00Z,188840952,8247984,0,23458,33,8271442
12,Could You Walk Up A Skyscraper?,2023-12-05T18:00:00Z,114290811,7185850,0,17929,31,7203779
13,"$10,000 Every Day You Survive In A Grocery Store",2023-12-02T17:00:00Z,211721643,5391562,0,76621,48,5468183
14,"$1 vs $10,000,000 Job!",2023-11-25T17:00:00Z,152414553,4067734,0,64671,22,4132405
15,I Spent 7 Days Buried Alive,2023-11-18T17:00:01Z,150673045,6111024,0,112288,27,6223312
16,I Gave Away A House On Halloween,2023-11-10T18:00:00Z,167813628,8704707,0,26177,32,8730884
17,Giving Car Keys Instead Of Candy On Halloween,2023-11-09T18:00:00Z,178422362,6964996,0,11295,45,6976291
18,I Built 100 Wells In Africa,2023-11-04T16:00:00Z,162912298,9523034,0,215007,27,9738041
19,"Furthest Away From Me Wins $10,000",2023-11-02T17:00:03Z,256244716,11252927,0,23980,34,11276907
20,World‚Äôs Most Expensive Bed,2023-10-31T17:00:01Z,197640507,11777072,0,22510,26,11799582
21,World‚Äôs Deadliest Laser Maze!,2023-10-28T15:59:59Z,165311957,4188124,0,86843,29,4274967
22,World‚Äôs Most Expensive Coffee,2023-10-19T17:00:03Z,132596511,7186465,0,21837,29,7208302
23,"$100,000,000 Bathroom",2023-10-17T17:00:00Z,169206298,8121208,0,16092,21,8137300
24,"$1 vs $100,000,000 House!",2023-10-14T16:00:00Z,197123412,5173086,0,134662,25,5307748
25,I Tipped A Pizza Delivery Driver A Car,2023-10-12T17:30:03Z,267662666,14776694,0,21897,38,14798591
26,World's Most Dangerous Trap!,2023-10-07T16:00:00Z,215131222,6036209,0,159182,28,6195391
27,I NEED 1 MORE ùó¶ùó®ùóïùó¶ùóñùó•ùóúùóïùóòùó•,2023-10-05T17:00:01Z,346609098,25145246,0,75664,24,25220910
28,"Guess The Gift, Keep It",2023-10-03T17:00:00Z,434861746,15891383,0,14377,23,15905760
29,"Spot The Hidden People For $10,000",2023-09-28T17:00:01Z,442095862,15885755,0,20026,34,15905781
30,I Paid A Random Student‚Äôs College Tuition,2023-09-26T16:59:59Z,223579144,14735830,0,30771,41,14766601
31,"$100,000,000 Car Doors",2023-09-19T17:00:00Z,479533531,16976044,0,23165,22,16999209
32,"$1 vs $100,000,000 Car!",2023-09-16T16:00:01Z,254604730,6331661,0,150489,23,6482150
33,Extreme Home Makeover!,2023-09-12T17:00:00Z,198894311,12785646,0,32521,22,12818167
34,Katana Vs Bullet,2023-09-07T17:00:01Z,584012244,25521784,0,35960,16,25557744
35,How Many School Buses Can We Stack?,2023-09-05T16:59:57Z,277206370,10984792,0,24191,35,11008983
36,Lamborghini Vs World's Largest Shredder,2023-09-02T16:00:00Z,170099053,5170884,0,151052,39,5321936
37,"Make This Kick, Win Super Bowl Tickets",2023-08-25T16:00:25Z,92990760,4052100,0,8477,38,4060577
38,Metal Pipe Vs School Bus,2023-08-22T17:00:00Z,298262767,10081794,0,23544,24,10105338
39,"Every Country On Earth Fights For $250,000!",2023-08-19T16:00:01Z,174567532,5807421,0,363013,43,6170434
40,Can You Beat A Girl In Arm Wrestling?,2023-08-17T17:00:00Z,285933310,13583074,0,29578,37,13612652
41,"$1 vs $250,000 Vacation!",2023-08-12T15:59:59Z,245343528,5900432,0,111272,24,6011704
42,I Ate The World‚Äôs Most Poisonous Fish,2023-08-08T17:30:01Z,343199565,16276082,0,33687,37,16309769
43,7 Days Stranded At Sea,2023-08-05T16:00:01Z,247369883,6979269,0,123757,22,7103026
44,I Traded My Car At a Red Light,2023-07-15T17:00:01Z,342996347,16635560,0,28179,30,16663739
45,Train Vs Giant Pit,2023-07-08T16:00:00Z,200692031,6096206,0,137846,18,6234052
46,I Buried Treasure in the Bermuda Triangle,2023-07-06T17:00:01Z,242956989,15889245,0,25290,41,15914535
47,"$1 vs $1,000,000,000 Yacht!",2023-06-10T16:00:00Z,312486060,6769668,0,154365,27,6924033
48,Do Pawnshops Scam You?,2023-06-03T16:59:57Z,217803893,10818469,0,20327,22,10838796
49,"Ages 1 - 100 Fight For $500,000",2023-05-27T21:14:59Z,349639337,6281171,0,122238,31,6403409
50,"1,000 Deaf People Hear For The First Time",2023-05-06T19:59:59Z,148922576,5246037,0,161764,41,5407801
51,Would You Pet a Cheetah in Africa?,2023-05-01T20:00:02Z,464768644,19573857,0,42900,34,19616757
52,Tipping A Waitress A Car,2023-04-22T20:00:00Z,340332265,18974711,0,45061,24,19019772
53,Would you go on a Blind Date in Italy?,2023-04-15T20:00:01Z,328625282,16904607,0,22417,38,16927024
54,"$1 vs $500,000 Plane Ticket!",2023-04-01T20:00:04Z,355857943,7483687,0,169527,28,7653214
55,I Sent a Subscriber to Disneyland,2023-03-30T20:00:00Z,401561944,21962354,0,60238,33,22022592
56,I Paid A Real Assassin To Try To Kill Me,2023-03-18T20:00:01Z,255675593,5865528,0,112979,40,5978507
57,Do Men Lie About Their Height?,2023-02-14T21:00:14Z,331297452,16310803,0,25224,30,16336027
58,"1,000 Blind People See For The First Time",2023-01-28T21:00:00Z,175081957,10229440,0,400630,41,10630070
59,I Survived 50 Hours In Antarctica,2022-12-24T20:59:59Z,184165011,5241098,0,151488,33,5392586
60,Hydraulic Press Vs Lamborghini,2022-12-10T21:00:01Z,221599005,5598937,0,132190,30,5731127
61,Would You Fly To Paris For A Baguette?,2022-12-08T20:12:27Z,1131742141,46329721,0,102631,38,46432352
62,"100 Kids Vs 100 Adults For $500,000",2022-12-03T21:00:00Z,239647978,4376690,0,96357,35,4473047
63,Gordon Ramsay Tries Most Expensive Chocolate Bar!,2022-11-19T20:59:59Z,443229634,21470061,0,38418,49,21508479
64,"Last To Take Hand Off Jet, Keeps It!",2022-11-12T21:00:00Z,164398006,4236050,0,104729,36,4340779
65,Giving iPhones Instead Of Candy on Halloween,2022-11-02T21:00:01Z,1110384665,33334623,0,122187,44,33456810
66,"$1 vs $1,000,000 Hotel Room!",2022-10-22T21:00:00Z,336764466,6960482,0,117882,28,7078364
67,"The Rock Vs MrBeast For $100,000",2022-10-21T20:00:06Z,512713593,29747933,0,70121,32,29818054
68,"Survive 100 Days In Circle, Win $500,000",2022-09-24T19:59:59Z,284473515,5673498,0,100971,40,5774469
69,I Hunted 100 People!,2022-09-03T19:59:59Z,157349153,3599792,0,68230,20,3668022
70,I Survived A Plane Crash,2022-08-20T20:00:00Z,180021713,3930755,0,78294,24,4009049
71,"I Gave My 100,000,000th Subscriber An Island",2022-08-04T19:59:59Z,203182967,6633486,0,236132,44,6869618
72,"100 Boys Vs 100 Girls For $500,000",2022-07-23T20:00:09Z,197410706,4587288,0,143305,34,4730593
73,I Didn‚Äôt Eat Food For 30 Days,2022-07-02T20:00:02Z,105975545,3937036,0,110894,29,4047930
74,I Built Willy Wonka's Chocolate Factory!,2022-06-04T20:00:02Z,288579483,6517178,0,165119,40,6682297
75,"$10,000 Every Day You Survive Prison",2022-04-09T20:00:00Z,204930348,5264171,0,133710,36,5397881
76,"Would You Swim With Sharks For $100,000?",2022-03-19T20:02:32Z,182397262,4072764,0,91380,40,4164144
77,World‚Äôs Most Dangerous Escape Room!,2022-01-29T21:00:01Z,256114172,5451832,0,136429,35,5588261
78,"Extreme $1,000,000 Hide And Seek",2021-12-18T21:00:00Z,101178517,3607699,0,124999,32,3732698
79,"$1,000,000 Influencer Tournament!",2021-12-16T21:00:00Z,87177561,3109220,0,88416,33,3197636
80,I Got Hunted By The Military,2021-12-10T21:30:02Z,209719384,4552322,0,96668,28,4648990
81,"$456,000 Squid Game In Real Life!",2021-11-24T21:00:01Z,587752210,17749202,0,623838,33,18373040
82,I Cleaned The World‚Äôs Dirtiest Beach #TeamSeas,2021-10-29T19:59:43Z,117883454,5512221,0,174557,46,5686778
83,"Last To Take Hand Off Lamborghini, Keeps It",2021-10-23T20:00:01Z,169973226,4589365,0,130497,43,4719862
84,"First To Rob Bank Wins $100,000",2021-09-26T20:00:06Z,179089267,4305752,0,120759,31,4426511
85,"Extreme $500,000 Game Of Tag!",2021-09-04T20:00:07Z,167916105,4508466,0,100458,29,4608924
86,"Last To Leave Circle Wins $500,000",2021-08-31T20:01:03Z,415972430,6939915,0,123671,34,7063586
87,I Got Hunted By The FBI,2021-08-07T23:00:03Z,203507943,4458616,0,96556,23,4555172
88,"If You Can Carry $1,000,000 You Keep It!",2021-07-24T20:00:59Z,188027125,3681224,0,79353,40,3760577
89,"Would YOU Quit School For $100,000?",2021-07-10T20:00:09Z,164724207,3495357,0,85319,35,3580676
90,I Survived 50 Hours In A Maximum Security Prison,2021-06-26T20:00:02Z,237940221,4072564,0,101298,48,4173862
91,"Hit The Target, Win $300,000",2021-06-12T20:00:01Z,179547435,3632086,0,83582,28,3715668
92,Anything You Can Fit In The Triangle I‚Äôll Pay For,2021-06-01T20:00:02Z,213696551,3380620,0,85713,49,3466333
93,I Got Hunted By A Real Bounty Hunter,2021-04-24T20:00:00Z,195937281,4130741,0,125960,36,4256701
94,"Extreme $100,000 Game of Tag!",2021-04-17T20:00:00Z,209568684,3798633,0,120458,29,3919091
95,"Would You Sit In Snakes For $10,000?",2021-04-10T21:00:07Z,303083201,5422086,0,143439,36,5565525
96,"I Bought The World's Largest Mystery Box! ($500,000)",2021-04-03T20:00:01Z,235042111,5164013,0,177589,52,5341602
97,I Spent 50 Hours Buried Alive,2021-03-27T20:00:04Z,316094948,8293523,0,253008,29,8546531
98,"Offering People $100,000 To Quit Their Job",2021-03-13T21:00:02Z,139524017,3368253,0,116177,42,3484430
99,I Sold My House For $1,2021-03-06T21:00:02Z,156082984,3845735,0,117648,22,3963383
100,"I Donated $300,000 To People In Need",2021-02-13T21:00:01Z,55468314,3040931,0,150424,36,3191355
101,"I Ate $100,000 Golden Ice Cream",2021-01-22T21:00:03Z,258412326,5840931,0,177115,31,6018046
102,I Bought Everything In 5 Stores,2021-01-09T21:01:25Z,170254440,5458404,0,194316,31,5652720
103,"Youtube Rewind 2020, Thank God It's Over",2021-01-01T21:00:03Z,70972861,5055693,0,285879,40,5341572
104,"I Put 1,000,000,000 Christmas Lights On A House (World Record)",2020-12-23T21:00:06Z,112357193,2897626,0,109567,62,3007193
105,I Opened A Restaurant That Pays You To Eat At It,2020-12-19T22:00:03Z,181941196,5053211,0,742610,48,5795821
106,"I Gave People $1,000,000 But ONLY 1 Minute To Spend It!",2020-12-15T21:00:11Z,202540189,6622268,0,187173,55,6809441
107,"Steal This $100,000 Diamond, You Keep It",2020-11-28T21:00:04Z,207741604,3600992,0,96018,40,3697010
108,"Press This Button To Win $100,000!",2020-11-14T21:00:02Z,299128205,4482642,0,92102,34,4574744
109,I Survived 24 Hours Straight In Ice,2020-10-29T20:17:44Z,157347281,4032199,0,196946,35,4229145
110,I Uber‚Äôd People And Let Them Keep The Car,2020-10-24T20:00:01Z,126922613,3919867,0,86495,41,4006362
111,I Filled My Brother‚Äôs House With Slime & Bought Him A New One,2020-10-10T20:00:31Z,219131426,3896011,0,119774,61,4015785
112,Hi Me In 5 Years,2020-10-04T20:00:54Z,122137508,6741936,0,246025,16,6987961
113,"Would You Rather Have A Giant Diamond or $100,000?",2020-09-26T20:40:02Z,161664551,2865521,0,73343,50,2938864
114,"I Gave My 40,000,000th Subscriber 40 Cars",2020-09-19T20:00:02Z,172422057,4483290,0,186750,41,4670040
115,Why I Haven‚Äôt Been Uploading,2020-09-17T20:00:05Z,56591213,2769994,0,98543,28,2868537
116,"Get This Random Person 1,000,000 Subscribers",2020-09-05T20:00:17Z,80821375,2584859,0,123352,44,2708211
117,Would YOU Rather Have A Lamborghini or This House?,2020-08-22T20:00:01Z,199264854,3857631,0,153120,50,4010751
118,"Last To Leave $800,000 Island Keeps It",2020-08-15T20:00:02Z,250396413,5499529,0,229731,38,5729260
119,I Bought A Private Island,2020-08-13T20:00:07Z,163159950,3857542,0,130999,25,3988541
120,"I Spent $1,000,000 On Lottery Tickets and WON",2020-08-08T20:00:02Z,132258345,3264505,0,87506,45,3352011
121,I Ate The World‚Äôs Largest Slice Of Pizza,2020-08-01T20:00:02Z,254827138,4406109,0,137841,40,4543950
122,I Adopted EVERY Dog In A Dog Shelter,2020-07-23T20:00:11Z,238725274,4940976,0,213681,36,5154657
123,"I Bought The World's Largest Firework ($600,000)",2020-07-03T21:00:20Z,215375264,5194897,0,183503,48,5378400
124,I Broke Into A House,2020-06-25T20:00:00Z,166439097,3573628,0,197129,20,3770757
125,"Would You Rather Have $100,000 OR This Mystery Key?",2020-06-13T20:00:01Z,211034947,3776046,0,121229,51,3897275
126,I Built The World's Largest Lego Tower,2020-06-06T20:00:01Z,172565834,3389350,0,77257,38,3466607
127,I Spent 50 Hours In Solitary Confinement,2020-05-30T20:10:08Z,313046779,4975473,0,119494,40,5094967
128,If You Click This Video I'll Give My Friend .001$,2020-05-23T21:01:02Z,206268375,7244134,0,169570,49,7413704
129,"I Gave $200,000 To People Who Lost Their Jobs (Corona Virus)",2020-05-07T19:59:59Z,46135217,1413939,0,66031,60,1479970
130,Videos I Could Not Upload...,2020-04-30T20:00:08Z,154801162,3934115,0,66995,28,4001110
131,I Spent 24 Hours In A Doomsday Bunker,2020-04-11T20:00:00Z,205260831,3278008,0,81731,37,3359739
132,"Giving $1,000,000 Of Food To People In Need",2020-03-27T20:00:05Z,58915797,1928979,0,67792,43,1996771
133,I Ran A Marathon In The World's Largest Shoes,2020-03-21T20:00:02Z,157745795,3458531,0,73121,45,3531652
134,"$70,000 Extreme Hide And Seek - Challenge",2020-03-13T20:00:04Z,137476167,2691790,0,70273,41,2762063
135,Anything You Can Fit In The Circle I‚Äôll Pay For,2020-03-07T21:00:00Z,286330998,5132401,0,116540,47,5248941
136,"I Ate A $70,000 Golden Pizza",2020-02-29T21:00:22Z,249102153,4321757,0,112933,28,4434690
137,"Lamborghini Race, Winner Keeps Lamborghini",2020-02-08T21:00:02Z,135124589,2660264,0,56567,42,2716831
138,I Gave My Credit Card To Random People,2020-02-01T21:00:01Z,183970931,3980900,0,99832,38,4080732
139,I Went Back To Boy Scouts For A Day,2020-01-25T21:00:01Z,120484604,2259971,0,46898,35,2306869
140,"$60,000 Extreme Hide And Seek - Challenge",2020-01-17T21:00:01Z,156337230,2824867,0,51304,41,2876171
141,"How I Gained 15,000,000 Subscribers In 1 Year",2020-01-03T21:10:01Z,19283781,899663,0,41600,45,941263
142,Important Youtube Announcement (please watch),2019-12-28T21:00:06Z,37447756,2445248,0,130558,45,2575806
143,"Giving 10,000 Presents To Kids For Christmas",2019-12-23T21:00:04Z,75111967,3103234,0,175180,44,3278414
144,"Spending $1,000,000 In 24 Hours",2019-12-21T21:00:01Z,184806154,4609869,0,128906,31,4738775
145,"Last To Take Hand Off $1,000,000 Keeps It",2019-12-19T21:00:12Z,137463992,3369038,0,302050,41,3671088
146,"Last To Stop Riding Bike Wins $1,000,000 (Part 4)",2019-12-14T20:59:57Z,64171853,1470054,0,93529,49,1563583
147,"Last To Leave Toilet Wins $1,000,000 (Part 3)",2019-12-07T21:11:07Z,96967327,1905224,0,50134,45,1955358
148,I Ordered Pizza And Tipped The House,2019-12-05T21:00:02Z,137147632,4239449,0,107407,36,4346856
149,"Last to Stop Swinging Wins $1,000,000 (Part 2)",2019-11-30T21:00:03Z,127754803,2273808,0,82364,46,2356172
150,"$50,000 Game Of Extreme Hide And Seek - Challenge",2019-11-28T21:00:01Z,155604582,3037428,0,52099,49,3089527
151,I Opened A FREE BANK,2019-11-23T21:00:17Z,115989709,2947659,0,96453,20,3044112
152,"Going Around A Ferris Wheel 1,000 Times Straight",2019-11-16T21:00:47Z,116759063,2509969,0,50645,48,2560614
153,"Last To Fall Wins $1,000,000 (Part 1)",2019-11-14T21:00:31Z,156001282,3073207,0,57181,37,3130388
154,Surviving 24 Hours Straight In The Bermuda Triangle,2019-11-09T21:00:55Z,229468249,4185964,0,100631,51,4286595
155,"I Spent $100,000 On Lottery Tickets And Won!",2019-10-31T20:00:02Z,53219389,1359008,0,30722,44,1389730
156,"Planting 20,000,000 Trees, My Biggest Project Ever!",2019-10-25T19:01:01Z,101399507,4420548,0,166589,51,4587137
157,"Last To Take Hand Off Boat, Keeps It",2019-10-19T20:06:01Z,126103010,2093592,0,58963,36,2152555
158,"I Searched 100 Dumpsters, Here's What I Found",2019-10-12T20:10:01Z,191066849,2915468,0,59214,45,2974682
159,"Going Through The Same Drive Thru 1,000 Times",2019-10-05T20:00:08Z,269629432,4919475,0,133214,45,5052689
160,"Donating $100,000 To Random Streamers",2019-09-28T20:29:58Z,62125086,1845518,0,44252,37,1889770
161,Surviving 24 Hours Straight In A Rain Forest,2019-09-21T21:00:00Z,131150869,2584040,0,73887,44,2657927
162,"Last To Leave Ramen Noodle Pool Wins $20,000",2019-09-13T20:00:05Z,73031434,1549104,0,44774,44,1593878
163,"Anything You Can Carry, I'll Pay For #2",2019-09-06T20:00:00Z,71508810,1545905,0,33521,39,1579426
164,"I Gave My Brother 24 Hours To Spend $100,000",2019-08-31T20:00:01Z,99394561,2486282,0,57963,44,2544245
165,I Opened A Free Car Dealership,2019-08-29T20:00:00Z,139634800,3438490,0,139806,30,3578296
166,"Last To Leave Pool Of $20,000 Keeps It",2019-08-24T20:00:01Z,171423910,3233417,0,83338,38,3316755
167,Surviving 24 Hours On A Deserted Island,2019-08-22T20:00:07Z,189024582,3479788,0,80314,39,3560102
168,"Last To Leave Roller Coaster Wins $20,000 - Challenge",2019-08-17T20:00:00Z,152557568,2969200,0,68205,53,3037405
169,I Won Every Prize At A Theme Park,2019-08-15T19:59:59Z,171520645,2959211,0,69287,33,3028498
170,Destroying My Friend's Car And Surprising Him With A New One,2019-08-10T20:00:00Z,109120397,2801715,0,62930,60,2864645
171,I Spent 24 Hours Straight At Area 51,2019-08-02T21:00:01Z,165725002,3748134,0,100657,36,3848791
172,"Can 50,000 Magnets Catch A Cannon Ball?",2019-07-20T20:00:02Z,124117511,2156410,0,47355,39,2203765
173,World's Largest Game Of Dodgeball,2019-07-12T20:05:00Z,82510925,1635389,0,57662,33,1693051
174,"Last To Leave Revolving Door Wins $50,000",2019-07-02T20:00:01Z,155214475,3567557,0,183173,41,3750730
175,Tipping Waitresses With Real Gold Bars,2019-06-21T20:00:01Z,69367560,1813194,0,86646,38,1899840
176,I Opened The World's First FREE Store,2019-06-15T20:00:00Z,89652134,2314347,0,77578,37,2391925
177,Spending 24 Hours On Top Of A Mountain,2019-06-13T20:00:01Z,194652220,3728395,0,116314,38,3844709
178,"Last To Leave VR Wins $20,000",2019-06-08T20:00:01Z,155061480,3197423,0,96172,29,3293595
179,"Last To Stop Running Wins $20,000",2019-06-06T20:00:00Z,114973763,2319552,0,67602,33,2387154
180,"Paying People $10,000 To Eat Ghost Pepper",2019-06-01T20:05:01Z,40457004,1124443,0,35937,41,1160380
181,24 Hours In The Most Haunted Place On Earth,2019-05-30T20:07:01Z,133448963,2973152,0,140510,43,3113662
182,I Bought Everything In A Store - Challenge,2019-05-18T20:05:02Z,152360771,4263434,0,184344,42,4447778
183,World's Largest Bowl Of Cereal,2019-05-15T21:05:01Z,212790909,3173572,0,87219,30,3260791
184,Spending 24 Hours In A City With No Laws,2019-05-07T21:00:01Z,166774386,2855073,0,68313,40,2923386
185,"Giving $10,000 To Random People And Saying Nothing",2019-04-30T20:00:06Z,80027451,1819784,0,51050,50,1870834
186,Molten Lava Vs Giant Ice Block Experiment,2019-04-27T20:00:02Z,96651696,1842393,0,43309,41,1885702
187,"Anything You Can Carry, I'll Pay For Challenge",2019-04-20T20:00:03Z,89523260,1758841,0,92532,46,1851373
188,Homeless Man Buys A Lamborghini,2019-04-18T20:05:00Z,170825742,3996264,0,80013,31,4076277
189,Playing Battleship With Real Ships,2019-04-06T20:05:58Z,37950494,1015942,0,35644,34,1051586
190,"Donating $100,000 To Shroud In Real Life",2019-04-04T21:05:59Z,32174767,881258,0,21024,40,902282
191,"Last To Leave The Tesla, Keeps It Challenge",2019-03-29T21:05:00Z,112644784,1992654,0,45720,43,2038374
192,"Donating $100,000 To Streamers With 0 Viewers",2019-03-24T20:00:04Z,96660923,3312508,0,74794,45,3387302
193,Surviving 24 Hours Straight In A Desert,2019-03-16T20:05:00Z,153628117,3033757,0,96260,39,3130017
194,"$200,000 Youtuber Battle Royale",2019-03-12T22:00:00Z,48446622,1659301,0,143577,31,1802878
195,Surprising Strangers With 100 Zombies - Experiment,2019-03-03T22:04:59Z,60419158,1795142,0,57279,50,1852421
196,I Gave A Homeless Man A Home,2019-02-28T22:06:00Z,81134815,2181306,0,113923,28,2295229
197,Standing Still For 24 Hours Straight - Statue Challenge,2019-02-22T22:05:59Z,114430497,1943672,0,37781,55,1981453
198,Giant Monopoly Game With Real Money,2019-02-15T22:05:00Z,112453230,2355552,0,69679,35,2425231
199,I Spent 24 Hours Straight In Insane Asylum,2019-02-10T21:05:00Z,117222136,2309021,0,136185,42,2445206
200,I Advertised Pewdiepie At The Super Bowl,2019-02-04T22:00:01Z,44889633,1259111,0,66249,40,1325360
201,I Went Back To 1st Grade For A Day,2019-01-31T22:05:00Z,208214708,3399172,0,143829,34,3543001
202,I Opened The World‚Äôs Cheapest Store,2019-01-26T21:05:00Z,41346130,1151177,0,84532,35,1235709
203,I Put 10 Million Legos in Friend's House,2019-01-18T22:04:59Z,102416980,1633158,0,63606,40,1696764
204,Make This Video The Most Liked Video On Youtube,2019-01-16T22:05:01Z,149482526,29976818,0,315514,47,30292332
205,"20,000 Magnets Vs A Car",2019-01-14T22:05:00Z,33997426,773535,0,24278,23,797813
206,"Eating A $10,000 Golden Steak (24k Gold)",2019-01-11T22:05:00Z,148518630,2361948,0,91533,40,2453481
207,Last To Take Hand Off House Keeps It!,2019-01-08T21:05:00Z,88252222,1604772,0,45001,37,1649773
208,"I Gave Him One Hour To Spend $100,000!",2019-01-01T21:05:01Z,78172889,1579681,0,69530,38,1649211
209,"How I Gave Away $1,000,000",2018-12-25T21:05:01Z,14471794,492368,0,34518,26,526886
210,"Giving $100,000 To A Homeless Person",2018-12-23T21:00:01Z,31321989,1031215,0,71982,36,1103197
211,I Spent 24 Hours Straight In Prison - Challenge,2018-12-19T21:05:02Z,115806649,2099348,0,75855,47,2175203
212,Donating $10000 To Pewdiepie,2018-12-16T21:05:02Z,47075154,1740605,0,50612,28,1791217
213,"Last Youtuber To Leave Wins $100,000 - Challenge",2018-12-12T21:00:02Z,101747618,2131936,0,97343,48,2229279
214,I Put Millions Of Pennies In My Friends Backyard,2018-12-08T21:05:02Z,157248792,2578915,0,64042,48,2642957
215,Surprising TFue With A Fortnite Battle Bus In Real Life,2018-12-07T22:11:00Z,101443140,1895365,0,64416,55,1959781
216,I Built A Giant House Using Only Legos,2018-12-02T20:05:01Z,64476390,1046135,0,50167,38,1096302
217,"Last To Leave Slime Pit Wins $20,000 - Challenge",2018-11-30T21:11:01Z,136483909,2305435,0,73264,48,2378699
218,"Saying Pewdiepie 100,000 Times",2018-11-25T21:07:01Z,25887697,1685510,0,171891,30,1857401
219,Destroyed Friend's House And Bought Him A New One,2018-11-24T21:06:01Z,43407366,1135498,0,69579,49,1205077
220,I Put 100 Million Orbeez In My Friend's Backyard,2018-11-22T21:08:01Z,210592956,4960635,0,138751,48,5099386
221,"Spending $40,000 In One Hour Challenge",2018-11-17T21:06:02Z,44373896,934946,0,55815,38,990761
222,"Giving My 10,000,000th Subscriber 10,000,000 ___",2018-11-13T21:05:04Z,29336062,810317,0,33021,48,843338
223,"$10,000 Games Of Rock Paper Scissors",2018-11-04T21:05:02Z,18480144,516067,0,25662,36,541729
224,"Last To Remove Hand, Gets Lamborghini Challenge",2018-11-02T20:05:01Z,91983973,1671428,0,75135,47,1746563
225,"You Pick The Right Cup, You Win $100,000!",2018-10-28T20:06:01Z,36152104,982597,0,36258,41,1018855
226,I Bought Every Billboard In My City For This,2018-10-26T21:06:02Z,38666937,1329295,0,109281,44,1438576
227,"Ordering Water Then Tipping $30,000",2018-10-23T20:11:02Z,43980956,1173718,0,47346,35,1221064
228,"I Spent $50,000 On Lottery Tickets And Won ____",2018-10-19T21:05:02Z,31162560,750517,0,34162,47,784679
229,"Last To Leave Circle Wins $10,000 - Challenge",2018-10-12T22:05:04Z,93058341,1610370,0,60120,45,1670490
230,I Spent 24 Hours Straight In Slime,2018-10-09T20:05:02Z,42816140,934927,0,34183,34,969110
231,"Surprising Tfue With $10,000 Live - Fortnite",2018-10-04T20:07:01Z,73463537,1533919,0,48055,44,1581974
232,"I Spent $30,000 On Lottery Tickets And Won ____",2018-09-28T21:05:00Z,17192876,426649,0,22617,47,449266
233,Flat Earth PROVEN By Independent Research,2018-09-22T20:05:01Z,28342676,801489,0,138734,41,940223
234,Things That SHOULDN'T Be Sold On Amazon,2018-09-21T22:06:01Z,147160298,2272122,0,56462,39,2328584
235,"Surprising My 8,000,000th Subscriber With 8,000,000 ___",2018-09-19T20:05:01Z,36400683,574387,0,18912,55,593299
236,"I Donated $25,000 To Random Kids Streaming Fortnite",2018-09-14T20:09:01Z,64077734,1311031,0,40273,51,1351304
237,I Hope This Magic Trick Works,2018-09-11T21:13:59Z,43287315,725607,0,19446,29,745053
238,Can A Glowing 1000 Degree Sword Slice A Car In Half?,2018-09-06T21:09:00Z,69605967,1151056,0,38898,52,1189954
239,Rocket League In Real Life!,2018-09-01T21:08:58Z,28604953,547316,0,16708,27,564024
240,Destroying My Friend's Car And Surprising Him With A New One - Slime,2018-08-28T22:08:59Z,115141640,2436874,0,68000,68,2504874
241,Spending 24 Hours Straight Under Water Challenge,2018-08-24T22:09:00Z,139912560,3502555,0,108750,48,3611305
242,"Attempting The Impossible Maze - $10,000 Challenge",2018-08-15T21:08:59Z,56640777,1019749,0,33094,50,1052843
243,"Donating $100,000 To A Random Fortnite Streamer",2018-08-05T22:00:00Z,52392437,1106240,0,51288,47,1157528
244,Moving 10 Pounds Using ONLY Sound,2018-08-02T21:09:00Z,45212871,1216140,0,51147,33,1267287
245,Returning Destroyed Rental Cars Prank,2018-07-27T21:09:00Z,36874822,619885,0,17869,37,637754
246,"I Gave My 6,000,000th Subscriber 6,000,000 ____",2018-07-25T21:11:00Z,17659146,397331,0,33042,47,430373
247,"Can 1,000 Fans At Max Speed Push A Car?",2018-07-17T21:41:02Z,28700970,626209,0,37595,39,663804
248,"I Donated $50,000 To Ninja - Fortnite",2018-07-14T21:06:00Z,97314705,2153513,0,61143,37,2214656
249,I Ubered Random People In A Tank,2018-07-11T21:16:00Z,29998331,873427,0,44796,32,918223
250,World's Hottest Substance Vs Coldest Substance,2018-06-30T21:09:00Z,92485236,1731582,0,54304,46,1785886
251,The Real Way Dinosaurs Went Extinct,2018-06-28T21:12:01Z,28962974,803315,0,44486,35,847801
252,I Donated $1000 Every Time She Blinked - Fortnite Streamers,2018-06-24T21:10:00Z,21723129,643306,0,25197,59,668503
253,I Built A Working Car Using Only LEGOS,2018-06-23T21:09:58Z,74659797,1669959,0,101754,38,1771713
254,Do Water Repellent Shoes Actually Work?,2018-06-22T22:11:00Z,129436673,1988499,0,65768,39,2054267
255,"We Drove 3,000 Miles For The World's Best Burger",2018-06-09T21:13:59Z,53364534,1220284,0,96927,48,1317211
256,"I Gave My 5,000,000th Subscriber 5,000,000 ______",2018-06-08T22:36:59Z,11276841,294712,0,19458,49,314170
257,I Made Money Grow On Trees,2018-06-01T22:09:00Z,17286637,435996,0,37053,26,473049
258,I Took Apart My Friends Car And Put It In His Room,2018-05-25T22:41:59Z,15761156,316229,0,12469,50,328698
259,How Many Rubber Bands Does It Take To Snap A Safe?,2018-05-22T22:14:01Z,37146627,921036,0,45988,50,967024
260,Pulling Cars Over Using A Toy Police Car,2018-05-13T21:10:01Z,24639462,548939,0,19311,40,568250
261,"I Gave $500,000 To Random People",2018-05-11T22:40:59Z,15084711,454779,0,31389,32,486168
262,How Many Toy Cars Does It Take To Pull A Real Car?,2018-05-04T22:08:58Z,41093576,767689,0,27434,50,795123
263,"I Gave $20,000 To People From An Ice Cream Truck",2018-05-02T22:11:00Z,14717446,348862,0,21491,48,370353
264,$10000 Ice Sculpture Vs Flame,2018-05-01T22:09:00Z,23759263,507769,0,30798,29,538567
265,"Can 1,000 Rolls Of Duct Tape Stop A Car??",2018-04-30T22:09:00Z,26859132,551984,0,25203,41,577187
266,Winning A Game Of Fortnite In The Middle Of The Ocean,2018-04-25T22:09:02Z,31351659,789483,0,48568,53,838051
267,I Flew Using Only Balloons AND Leaf Blowers,2018-04-23T22:09:02Z,32571860,657760,0,45447,43,703207
268,"I Donated $40,000 To A Random Twitch Fortnite Streamer (world record)",2018-04-21T21:07:02Z,24414264,632772,0,29674,69,662446
269,Destroying My Friend's Car And Surprising Him With A New One,2018-04-13T22:21:00Z,38854459,629001,0,36442,60,665443
270,Walking Up To Random People With 100 StormTroopers,2018-04-11T22:09:01Z,19375850,499436,0,39469,50,538905
271,"I Donated $10,000 If They Said This Word (Twitch Streamers)",2018-04-04T22:19:00Z,20041027,557857,0,22406,59,580263
272,"Giving My 4,000,000th Subscriber 4,000,000 Cookies",2018-04-02T22:09:01Z,13245008,344763,0,25513,50,370276
273,"I Tipped Waitresses $20,000",2018-03-30T21:09:03Z,14799919,355187,0,20087,27,375274
274,Walking Into Random Stores With 100 Dinosaurs,2018-03-22T22:43:02Z,33055034,896833,0,45502,45,942335
275,I Built A Mansion Using Only Cardboard Boxes,2018-03-20T22:50:00Z,25664636,577513,0,24090,44,601603
276,Breaking Glass Using Only Megaphones,2018-03-17T22:22:47Z,54039832,1416755,0,76492,36,1493247
277,Tying My Shoes In Every State (World Record),2018-03-16T22:09:02Z,17997213,454326,0,42573,44,496899
278,"I Dropped $20,000 From A Drone",2018-03-08T00:13:02Z,7765683,249823,0,17527,30,267350
279,"Donating $10,000 To Fortnite Streamers If They Win",2018-03-03T23:21:02Z,11330665,274722,0,15958,50,290680
280,Trying To Fly Using Only Leaf Blowers,2018-03-01T23:09:03Z,18329622,431279,0,29357,37,460636
281,"Giving 3,000,000 Pennies To My 3,000,000th Subscriber",2018-02-22T23:14:03Z,8754455,235222,0,22375,53,257597
282,"I Donated $30,000 To My Favorite Twitch Streamer (ninja)",2018-02-21T23:19:01Z,36695074,864071,0,39419,56,903490
283,"I Gave $20,000 To Random Homeless People",2018-02-17T00:40:00Z,47484124,1324303,0,74545,40,1398848
284,I Bought An Expensive Car Using Only $1 Bills,2018-02-13T23:10:01Z,37406530,1084041,0,36325,45,1120366
285,I Bought The World's Most Expensive Apps ($10k),2018-02-08T23:35:00Z,27012428,768596,0,26013,47,794609
286,We Delivered 100 Pizzas To Random Houses,2018-02-02T23:12:01Z,9142393,229128,0,11334,40,240462
287,"I Donated $30,000 To A Random Twitch Streamer (world record)",2018-01-28T00:11:02Z,32757027,1058015,0,55871,60,1113886
288,I Bought A Car Using Only Pennies,2018-01-25T23:10:03Z,26440485,723013,0,39494,33,762507
289,I Bought One Snickers Bar From Every Walmart,2018-01-13T23:15:01Z,44681530,1129162,0,72484,44,1201646
290,Donating Big Donations To Twitch Streamers!!!,2018-01-11T22:37:00Z,27618628,582323,0,37081,45,619404
291,I Can't Believe I Found This Stuff On Amazon..,2017-12-22T23:19:10Z,30926067,1201791,0,24339,46,1226130
292,"Saying ""Keep Net Neutrality"" For 10 Hours",2017-12-17T20:37:34Z,2262809,82233,0,10001,41,92234
293,Life Hacks You Need To Know,2017-12-08T22:49:10Z,7353160,203294,0,11048,27,214342
294,"Can 100,000 Pieces Of Paper Stop A Bullet?",2017-12-06T22:46:59Z,25922826,485453,0,57244,42,542697
295,"Giving My Mom $100,000 (Proudest Day Of My Life)",2017-12-02T21:10:08Z,31417054,1528359,0,44517,48,1572876
296,"2,256 Miles In One Uber Ride (World Record)",2017-10-28T22:30:00Z,42495996,1100709,0,43547,43,1144256
297,i'm really sorry,2017-10-26T21:30:00Z,5821335,205987,0,10589,16,216576
298,Hi Me In Two Years (Made Two Years Ago),2017-10-04T21:30:00Z,13601649,604347,0,39414,39,643761
299,"Tipping Uber Drivers $10,000",2017-08-30T22:40:02Z,4616706,128024,0,8379,28,136403
300,Going To The Connor McGregor fight!,2017-08-28T20:31:04Z,6049894,230832,0,11602,35,242434
301,"Tipping Pizza Delivery Guys $10,000",2017-08-23T21:44:24Z,22161099,695636,0,40884,35,736520
302,"Microwaving my iPhone, what happens next might shock you..",2017-08-20T19:37:51Z,2741821,123989,0,8829,58,132818
303,"Saying Logan Paul 100,000 Times",2017-08-19T14:00:58Z,23164515,927515,0,111298,31,1038813
304,"Donating $10,000 To Random Twitch Streamers",2017-08-15T19:20:09Z,10803562,226847,0,18011,43,244858
305,Breaking The Law,2017-07-09T21:20:50Z,32011241,840995,0,34704,16,875699
306,"Giving Homeless People $1,000 (Not Clickbait)",2017-06-28T22:00:02Z,6528679,227536,0,19371,45,246907
307,We Are Better Than Dude Perfect,2017-06-24T18:40:12Z,25941911,665381,0,38944,31,704325
308,Every Challenge I've Ever Done,2017-06-23T18:31:22Z,896070,28904,0,4647,30,33551
309,Watching It's Everyday Bro For 10 Hours Straight,2017-06-17T21:06:02Z,28056941,824826,0,71235,48,896061
310,"Giving A Random Homeless Man $10,000",2017-06-15T23:10:02Z,10966133,552797,0,34393,36,587190
311,Toothpaste Life Hacks YOU SHOULD KNOW,2017-06-13T22:30:01Z,19732992,504763,0,15639,37,520402
312,"Reading The Longest English Word (190,000 Characters)",2017-06-02T22:00:01Z,35446786,823243,0,59381,53,882624
313,Fidget Spinner Vs Face (Legit Had To Get Stitches),2017-05-02T23:30:00Z,42938041,1654614,0,89639,50,1744253
314,Grilling A Microwave Microwaving A Microwave Microwaving A Toaster Toasting An Iphone Watching Micro,2017-03-30T22:10:41Z,2057360,71333,0,5111,100,76444
315,#1 MOST INSANE MAGNET LIFE HACK EVER,2017-03-24T21:40:17Z,26242488,527999,0,18464,36,546463
316,Watching Dance Till You're Dead For 10 Hours,2017-03-21T22:40:12Z,53056793,2587140,0,0,44,2587140
317,I Can't Break My Strange Addiction,2017-03-19T21:45:07Z,1873991,95050,0,9132,34,104182
318,OMG! INSANE CUP FORT,2017-03-14T22:40:01Z,4113833,96713,0,9438,20,106151
319,Savage Level 9000,2017-03-08T23:10:06Z,7294371,322518,0,21028,17,343546
320,Reading The Youtube Terms Of Service,2017-03-07T23:10:02Z,535246,19258,0,3665,36,22923
321,Reacting To The Reaction Of The Reaction To The Reaction Of The Reaction Of The Reaction To The Reac,2017-02-22T00:00:04Z,7663099,325055,0,25735,100,350790
322,"Counting To 200,000 (Road To A Mil)",2017-02-18T00:00:03Z,3860270,151049,0,19434,35,170483
323,Microwaving Dry Ice (Microwave Explodes),2017-02-09T22:29:35Z,3323726,97165,0,6221,40,103386
324,"I Counted To 100,000!",2017-01-09T00:00:39Z,29915666,1424157,0,126152,21,1550309
325,we are number one but every one is a bad intro,2016-12-25T00:00:00Z,1965589,56443,0,8465,46,64908
326,Microwaving A Microwave Microwaving A Toaster,2016-12-23T00:00:04Z,4901142,88920,0,15399,45,104319
327,HOW TO UNLOCK ANY IPHONE WITHOUT THE PASSCODE,2016-12-21T02:00:00Z,22931604,583658,0,34498,45,618156
328,WHY DO THEY SELL THIS ON AMAZON?,2016-12-18T02:00:04Z,8753252,724846,0,15918,32,740764
329,Microwaving A Microwave,2016-12-09T02:45:18Z,11466400,436518,0,42046,23,478564
330,IF YOU ONLY SEE ORANGE YOU'RE COLOR BLIND,2016-12-05T02:21:43Z,1806655,93883,0,7796,41,101679
331,I Mailed Myself IN A BOX & it REALLY WORKED! (Human Mail Challenge),2016-11-30T02:31:18Z,16299718,456463,0,17793,67,474256
332,STUPIDEST PERSN ON EART (Really Dumb),2016-11-28T00:01:52Z,2508863,185849,0,12820,37,198669
333,"Reading The Entire Bee Movie Script But Everytime They Say ""Bee"" I Repeat All the Previous Bees",2016-11-25T01:43:37Z,10908028,217289,0,12461,95,229750
334,THE WORST THINGS EVER TO EXIST,2016-11-19T00:40:47Z,3745218,330369,0,19001,30,349370
335,BLOWING UP $1000 KEYBOARD *RIP WALLET*,2016-11-11T23:02:10Z,3856542,229058,0,5057,38,234115
336,MY $1000 KEYBOARD CHANGED MY LIFE,2016-11-03T21:32:53Z,13401941,357814,0,8181,33,365995
337,I BOUGHT A 1000$ KEYBOARD,2016-10-25T21:06:50Z,1584816,37863,0,2833,25,40696
338,IF ONLINE ADS WERE REAL,2016-10-16T20:30:00Z,9865952,585320,0,18464,23,603784
339,IT FINALLY CAME IN THE MAIL,2016-10-10T21:05:39Z,309134,10882,0,1299,27,12181
340,Bleach Bottle Flips (COP CALLED),2016-10-09T20:06:23Z,1214914,55364,0,3150,32,58514
341,Hi Me In A Year (Scheduled Uploaded A Year Ago),2016-10-04T21:00:01Z,1565154,51985,0,4649,47,56634
342,Epic New Gaming And Youtube Setup 2016,2016-09-30T22:32:04Z,391804,14588,0,968,38,15556
343,24 HOUR EXPLOSION GIVEAWAY! WIN GIFTCARDS,2016-09-05T22:31:58Z,745547,33408,0,4679,41,38087
344,LISTENING TO OLD VOICEMAILS FOR THE FIRST TIME,2016-08-28T21:00:01Z,334481,10847,0,1031,46,11878
345,GAMBLING MONEY WITH SCRATCH OFF TICKETS,2016-08-26T22:30:01Z,3039177,59186,0,3479,39,62665
346,BEST WALMART TOILET PAPER FORT,2016-08-24T21:00:01Z,1457690,51283,0,3101,30,54384
347,100 LAYERS OF SARAN WRAP + TOILET PAPER!!,2016-08-23T21:01:56Z,3267914,138761,0,7037,41,145798
348,WORST REVIEWS ON AMAZON #4 *FUNNY*,2016-08-21T21:17:07Z,1649113,126117,0,3764,34,129881
349,HOW MUCH MONEY DO YOUTUBERS MAKE?,2016-08-14T20:20:03Z,3105360,153158,0,5625,33,158783
350,THE WORST SONG ON YOUTUBE *CRINGE*,2016-08-08T20:00:02Z,817291,41925,0,6798,34,48723
351,SURPRISING MY BROTHER WITH A LAPTOP,2016-08-07T19:35:12Z,1664960,115897,0,4275,35,120172
352,"SELLING ORGANS FOR $1,000,000",2016-08-02T20:02:21Z,3578669,122481,0,7637,29,130118
353,POKEMON GO STEREOTYPES,2016-07-14T17:36:53Z,2237069,64377,0,2680,22,67057
354,"100,000 SUBSCRIBERS.EXE",2016-07-08T20:00:00Z,1358685,77408,0,7884,23,85292
355,WORST REVIEWS ON AMAZON #2 HOW IS THIS LEGAL?,2016-07-02T20:30:01Z,1183396,46270,0,5169,45,51439
356,BLOWING UP MY TABLET,2016-07-01T20:30:01Z,163707,7153,0,1245,20,8398
357,Worst Reviews On Amazon #1 (Minecraft Edition),2016-06-26T21:24:27Z,708255,17190,0,1527,46,18717
358,WORST THUMBNAILS ON YOUTUBE #3,2016-06-21T20:01:20Z,853960,34164,0,1804,30,35968
359,REACTING TO MY OLD MINECRAFT VIDEOS (HORRIBLE),2016-06-19T20:36:36Z,1321650,35882,0,2794,46,38676
360,HOW TO MAKE A GOOD INTRO FOR YOUTUBE,2016-06-14T20:51:19Z,175888,5846,0,1366,36,7212
361,WORST BANNERS ON YOUTUBE #1,2016-06-13T21:13:33Z,656350,18616,0,3658,27,22274
362,"50,000 Subscribers.exe",2016-06-11T21:01:16Z,443434,18879,0,3087,22,21966
363,Dude Perfect 4.0 - We Are Totally Better,2016-06-06T21:01:41Z,415219,12792,0,1814,40,14606
364,CUTTING TABLE IN HALF WITH PLASTIC KNIVES,2016-06-04T20:31:28Z,3676339,164796,0,7019,41,171815
365,BEST INTROS ON YOUTUBE #1,2016-06-01T20:42:11Z,28198556,822651,0,31876,25,854527
366,Motivation For Youtubers #6 LAST ONE,2016-05-24T15:00:01Z,137482,5728,0,509,36,6237
367,How Many Licks Does It Take To Get To The Center Of A Tootsie Pop?,2016-05-19T21:00:01Z,371540,11872,0,2565,66,14437
368,Motivation For Youtubers #5,2016-05-15T21:00:01Z,176805,8099,0,556,27,8655
369,18th Birthday QNA - Mom's Hair Dryer Age?,2016-05-07T21:00:00Z,351686,14526,0,847,41,15373
370,WORST MEMES AND TRENDS ON YOUTUBE!,2016-05-01T21:00:00Z,629417,12779,0,1380,34,14159
371,Cereal Commentary,2016-04-28T00:36:58Z,139648,4959,0,600,17,5559
372,WHERE IS MY COOKIE?????,2016-04-24T21:31:29Z,110562,11887,0,1281,23,13168
373,"How Much Money Do Big Youtubers Make? (Pewdiepie, Markiplier, etc)",2016-04-22T21:02:56Z,103866,4310,0,436,66,4746
374,Struggles Of Being A Youtuber,2016-04-19T21:30:01Z,119248,4762,0,1067,29,5829
375,Reenacting Youtubers,2016-04-16T21:32:25Z,160528,6579,0,554,20,7133
376,Life Before And After Gamma (Insane) @GFuelEnergy,2016-04-13T23:08:34Z,45044,1863,0,611,49,2474
377,Worst Thumbnails On Youtube #2 - Cringe,2016-04-10T22:00:00Z,276857,10037,0,550,39,10587
378,Motivation For Small Youtubers #4 - Inspiration For Youtubers,2016-04-08T00:11:29Z,131373,6677,0,632,61,7309
379,Scheduled Uploaded 6 Months Ago (REACTION),2016-04-06T21:02:02Z,127254,4787,0,456,42,5243
380,Dude Perfect 3.0 - We Are Better,2016-04-04T21:30:00Z,694948,21353,0,1948,32,23301
381,Dear Future Me (Scheduled Uploaded 6 Months Ago),2016-04-04T19:30:01Z,2208707,131074,0,12665,48,143739
382,$100 GIVEAWAY PRANK (NO WEAPONS INVOLVED),2016-04-03T21:00:00Z,57948,1625,0,247,41,1872
383,GIVING AWAY $100 ITUNES GIFT CARDS,2016-04-01T20:45:18Z,123713,3911,0,472,34,4383
384,Walking Dead Daryl DIED (Fan Reaction To Death),2016-03-28T02:10:15Z,146053,3745,0,484,47,4229
385,Why Do Youtubers Ask For Likes?,2016-03-27T21:50:19Z,166904,11686,0,676,31,12362
386,Making My Background More Epic,2016-03-26T21:00:00Z,45896,2003,0,291,30,2294
387,Doing Youtube For Fun Or Views?,2016-03-23T23:51:29Z,45120,2054,0,239,31,2293
388,Pranks That Went Horribly Wrong,2016-03-19T21:00:00Z,2087224,89925,0,3019,31,92944
389,Who Founded Faze? Who Created Faze Clan?,2016-03-18T00:23:07Z,2023155,72861,0,3813,40,76674
390,Subscriber Goals For 2017,2016-03-09T23:35:32Z,67510,2539,0,1299,25,3838
391,"20,000",2016-03-08T00:35:01Z,159575,5344,0,767,6,6111
392,The Dreaded Unanswerable Question,2016-02-29T23:56:41Z,126643,3783,0,323,33,4106
393,WORST THUMBNAILS ON YOUTUBE,2016-02-28T20:48:25Z,573347,23812,0,1157,27,24969
394,Beast Goes Camping (Didn't Go Wrong) (Didn't Go Sexual),2016-02-20T23:07:55Z,151749,4187,0,335,55,4522
395,NBA Interviews Gone Wrong (No Gun Pulled),2016-02-20T14:56:51Z,56251,1777,0,157,41,1934
396,Movie Trailers Be Like,2016-02-15T18:31:34Z,95191,4182,0,267,22,4449
397,What Is Youtube Red? Should I Buy Youtube Red?,2016-02-10T23:42:47Z,96819,3622,0,344,46,3966
398,Things I Hate #2 - Youtube Edition,2016-02-09T01:26:28Z,158637,7295,0,1458,34,8753
399,Super Bowl Commercial 2016 Cost - How Much Does A Commercial Cost In 2016 Super Bowl?,2016-02-07T18:20:40Z,82300,2292,0,313,85,2605
400,Counting To 10000 In One Sitting,2016-02-01T00:27:55Z,68153039,721215,0,59972,32,781187
401,HOW TO MAKE A VIRAL PRANK VIDEO 100% LEGIT,2016-01-26T21:38:09Z,140921,5499,0,434,42,5933
402,Is Obama Dead? Dumb Google Searches!,2016-01-24T00:21:47Z,220359,4553,0,292,36,4845
403,How To Be MrBeast (Made By Really Old Subscriber),2016-01-23T19:46:56Z,62724,2692,0,294,49,2986
404,Should You Play Video Games?,2016-01-22T17:04:58Z,85395,4006,0,180,28,4186
405,School Is A Waste Of Time,2016-01-21T22:45:37Z,120325,5446,0,748,25,6194
406,Is Michael Bay My Dad????????,2016-01-18T21:46:21Z,69181,2189,0,253,29,2442
407,Lottery Taxes - How Much Tax Is If You Win The Lottery,2016-01-16T19:25:35Z,126453,3418,0,270,54,3688
408,Motivation For Small Youtubers #3,2016-01-12T00:57:36Z,161735,8660,0,1261,33,9921
409,Giving Away Two $15 Gift Cards (forgive me boyz),2016-01-10T23:32:03Z,44729,2467,0,404,48,2871
410,Do Dislikes Matter On Youtube - Are Dislikes Bad Or Good?,2016-01-07T22:19:01Z,369881,23762,0,2159,57,25921
411,How To Get Active Subscribers On Youtube? Tips 2016,2016-01-05T22:05:42Z,83547,4126,0,723,51,4849
412,Reaction Channels Are Stupid??????? #JCTG,2016-01-05T01:49:06Z,63471,1954,0,427,41,2381
413,Goodbye Laptop,2016-01-01T23:49:09Z,154374,6664,0,631,14,7295
414,2015 Year Highlights,2015-12-30T20:18:43Z,61290,2202,0,515,20,2717
415,MrBeast Rest In Pepperoni 6000,2015-12-27T20:15:59Z,215041,5754,0,469,30,6223
416,How To Think Of Good Video Ideas (Tips),2015-12-26T17:38:52Z,109453,7231,0,530,39,7761
417,Whats That Song Name?,2015-12-24T17:01:11Z,187301,7403,0,1470,21,8873
418,The Anti-Beast (R.I.P. Beast),2015-12-23T23:51:22Z,759965,26744,0,1783,29,28527
419,"Reacting To Family Accounts (MamaBeast, MrBeast'sLaptop, Etc)",2015-12-22T22:30:23Z,927630,20271,0,2029,61,22300
420,Do Youtubers Pay Taxes????? (USA),2015-12-19T19:21:52Z,96603,4060,0,425,33,4485
421,Why Does This Video Have No Thumbnail?,2015-12-15T01:43:00Z,80983,3693,0,475,38,4168
422,Totally 100% Real Epic Ping Pong Trickshots,2015-12-11T22:00:01Z,75313,3890,0,305,43,4195
423,Exams Be Like,2015-12-10T00:15:18Z,341338,11472,0,869,13,12341
424,How Many People Have A Silver Play Button????,2015-12-08T22:22:47Z,322324,10052,0,683,45,10735
425,How To Get More Views And Subscribers On Youtube (2016),2015-12-03T21:00:00Z,64320,3085,0,316,55,3401
426,Should You Do COD Commentaries In 2016????,2015-12-02T23:51:26Z,47861,1254,0,275,42,1529
427,THINGS I HATE #1,2015-12-02T01:20:16Z,414161,14515,0,1640,16,16155
428,Worst MrBeast6000 Intros?? (Fan Made!),2015-11-30T21:38:00Z,478024,13198,0,1797,38,14995
429,Dear Razer Can I Have My 70$ Back?????,2015-11-29T21:10:16Z,7579761,353297,0,25995,38,379292
430,"How Many People Get The Golden Play Button? (1,000,000 Subscribers)",2015-11-28T00:45:38Z,128161,3454,0,524,67,3978
431,"Spam404 Has Terminated 5,000,000 Videos (Including Pewdiepie)",2015-11-26T17:36:51Z,104783,2581,0,289,61,2870
432,MrBeast6000's First Video (So Bad lol),2015-11-19T21:29:40Z,13862832,538622,0,36570,38,575192
433,The Evolution Of My Youtube Banners,2015-11-18T21:16:57Z,65074,2225,0,441,35,2666
434,"Shark Tank Most Successful Products, Entrepreneurs, Or Businesses 2015",2015-11-08T19:33:42Z,140310,1198,0,188,70,1386
435,PSYCHO FRIEND SMASHES MY LAPTOP! (Mc Juggernuggets Parody),2015-11-06T00:07:37Z,261521,10625,0,889,58,11514
436,FREE TO USE BO3 GAMEPLAY - 1080p,2015-11-03T01:58:07Z,48377,1621,0,147,32,1768
437,Double Agent (Short Film),2015-11-01T14:33:38Z,137380,5383,0,459,25,5842
438,YOU ONLY DO YOUTUBE FOR VIEWS,2015-10-29T21:12:15Z,67913,3144,0,254,29,3398
439,"10,000 QNA With MUM",2015-10-29T00:21:29Z,294528,13277,0,1778,19,15055
440,Why I Stopped Playing Video Games - Video Game Commentary,2015-10-25T21:20:24Z,57456,1564,0,206,57,1770
441,YOUTUBE RED STEALS CONTENT CREATORS MONEY? What Is Youtube Red?,2015-10-21T23:13:36Z,49603,2154,0,198,63,2352
442,Millions Of Views!,2015-10-18T23:15:40Z,687621,23297,0,1639,18,24936
443,"How To Get 1,000 Subscribers On Youtube - Vlogs Gaming",2015-10-15T20:12:22Z,83738,4059,0,527,54,4586
444,High School Education Be Like (Paying Taxes),2015-10-14T21:10:31Z,47844,1723,0,214,44,1937
445,I Got Bored Of Studying So This Happened,2015-10-13T01:15:19Z,538132,17161,0,909,40,18070
446,Best Microphone For Youtube (Gaming Commentaries Vocals Singing Podcast),2015-10-11T18:56:01Z,44811,1666,0,286,72,1952
447,9k Subs - Channel Talk,2015-10-10T17:20:05Z,96516,3469,0,779,22,4248
448,How Much Money Does Bill Gates Make / Have - Billionaire,2015-10-09T22:27:01Z,104844,3351,0,340,56,3691
449,MrBeast6000's Channel Trailer,2015-10-08T20:00:00Z,1581648,125502,0,13233,29,138735
450,Best Non-Copyrighted Songs For Videos! (Intros Vlogs Gaming Trailers) 2016,2015-10-05T22:41:22Z,73072,2371,0,263,74,2634
451,Is Being A Youtuber Hard? Is Being A Youtuber Worth It?,2015-10-04T20:35:42Z,87168,3952,0,607,55,4559
452,Best Green Screen Lighting Ever? (Joking Obviously),2015-10-03T21:06:46Z,378073,9936,0,550,51,10486
453,How Do Youtubers Make Money? How Do Youtubers Get Paid?,2015-09-29T23:16:50Z,91705,3194,0,459,55,3653
454,Increase Youtube Views 2015! COMMUNITY CHANNELS - Boosting Youtube Views,2015-09-27T21:04:03Z,44777,1547,0,286,72,1833
455,Originality - A Youtube Poem By MrBeast6000,2015-09-26T23:04:34Z,45259,1878,0,295,43,2173
456,Stupid Things People Search On Google,2015-09-25T22:57:49Z,1365088,73018,0,4238,37,77256
457,"Ad Blocker For Chrome and Mobile, Should You Use It?",2015-09-23T23:54:06Z,79881,3108,0,512,52,3620
458,PC Master Race Vs Console Peasants,2015-09-21T23:40:01Z,48801,2196,0,266,34,2462
459,Shia Labeouf Motivates Youtubers!,2015-09-19T22:53:26Z,275858,8311,0,475,33,8786
460,Knives In Video Games Cost More Than Real Life????,2015-09-18T23:57:02Z,56888,1998,0,277,50,2275
461,"Why I Sold My PS4, Not A Gaming Channel???",2015-09-18T00:21:53Z,48013,1989,0,283,42,2272
462,Selling PS4 For $250 + Elgato For $100!,2015-09-16T22:26:34Z,44665,1384,0,254,39,1638
463,Do Tags Do Anything On Youtube?????,2015-09-13T20:48:10Z,119701,4947,0,611,35,5558
464,Bronze And Platinum Play Buttons?????,2015-09-13T00:23:55Z,861551,26022,0,2437,37,28459
465,7k SUBS! Smashing Ghost + AW! Plus Channel Talk!,2015-09-09T21:48:18Z,70132,2838,0,357,48,3195
466,Exility vs Dr.Pineapplez - Misleading Contest!,2015-09-08T22:06:36Z,45443,4220,0,791,46,5011
467,6 Uses For Your Advanced Warfare Disk!,2015-09-07T20:40:56Z,44703,1725,0,305,38,2030
468,MrBeast‚Äôs Outro Song,2015-09-05T20:15:02Z,8441142,384598,0,19703,20,404301
469,Watching Video Games Is A Waste Of Time????,2015-09-05T16:14:19Z,44919,1557,0,374,43,1931
470,"Pewdiepie's Shoutout, What Would You Do If You Won?",2015-09-05T00:49:25Z,48430,1943,0,312,51,2255
471,How I Will Survive The Zombie Apocalypse!,2015-08-31T22:11:06Z,222674,6605,0,751,41,7356
472,How Much Money Do Youtubers Make? Real Numbers!,2015-08-30T21:37:55Z,303504,8892,0,532,47,9424
473,HONEST Shout Out Sunday! Free Subscribers!,2015-08-30T18:06:45Z,44909,1518,0,543,42,2061
474,Social Media As A Job????,2015-08-29T18:20:31Z,44712,1733,0,438,25,2171
475,Airplane Pilots Last Words Before Death,2015-08-28T21:56:21Z,124027,2383,0,207,39,2590
476,How Much Do T.V. Commercials Cost?????,2015-08-28T01:40:10Z,44659,1317,0,243,38,1560
477,How To Tweet When You're Dead! DEADSOCIAL Facebook And Instagram Also!,2015-08-27T10:00:01Z,44721,1606,0,365,70,1971
478,My Favorite FaZe Clan Members?????,2015-08-26T10:00:00Z,47142,1644,0,219,34,1863
479,MrBeast6000Subs,2015-08-23T11:00:00Z,772689,50354,0,4312,15,54666
480,"Youtube Networking - Aka Fake Likes, Subs, And Comments",2015-08-21T20:04:55Z,44753,2430,0,429,55,2859
481,I Hate Youtubers That Ask For Likes,2015-08-20T19:13:03Z,173231,9862,0,712,35,10574
482,My Mom Found My Channel!! :0,2015-08-20T01:44:22Z,701590,24806,0,2460,28,27266
483,1080p FREE TO USE BLACK OPS 3 GAMEPLAY,2015-08-19T21:35:16Z,70068,1656,0,173,38,1829
484,"Black Ops 3 First Impressions, My First Game",2015-08-19T02:44:52Z,44748,1412,0,369,44,1781
485,Dogs Opinions On Youtubers Getting BO3 Early,2015-08-18T20:55:37Z,78337,2606,0,174,44,2780
486,BO3,2015-08-18T17:07:49Z,923510,25941,0,1951,3,27892
487,Xbox One Destroyer? COD Advertisement Is Free,2015-08-18T01:08:14Z,44887,1441,0,298,45,1739
488,What Is Yanet Actually Thinking?????,2015-08-17T01:24:47Z,146425,2866,0,220,36,3086
489,Modern Art Is A Joke,2015-08-15T10:00:01Z,54565,1805,0,161,20,1966
490,5 Steps To Becoming Successful On Youtube!,2015-08-14T10:00:03Z,69006,2968,0,368,42,3336
491,Time,2015-08-13T10:00:00Z,73418,1890,0,282,4,2172
492,Beast $500ish Youtube PC Great For Making Videos!,2015-08-12T10:00:00Z,69715,1387,0,185,49,1572
493,"5,000 Hype",2015-08-11T10:00:00Z,130400,3072,0,546,10,3618
494,What Is Crohns Disease?????,2015-08-10T10:00:01Z,236866,6547,0,583,27,7130
495,Leaving For 7 Days,2015-08-09T14:26:58Z,47177,1275,0,197,18,1472
496,Motivation For Youtube - Ultimate Small Youtuber Motivation #2,2015-08-08T22:15:43Z,154768,6169,0,680,62,6849
497,Should I Buy An Elgato Game Capture??,2015-08-07T10:00:00Z,46159,1705,0,451,37,2156
498,Fanboy Opinions On Black Ops 3,2015-08-06T00:58:47Z,44661,1134,0,265,30,1399
499,Big Channel's Starting Over???,2015-08-05T10:00:02Z,46957,1342,0,277,30,1619
500,SAT And Some Random Stuff,2015-08-04T22:14:13Z,44841,1363,0,564,25,1927
501,How Many Youtubers Are Millionaires???,2015-08-04T00:18:58Z,97953,1736,0,249,38,1985
502,Always Changing My Name? Mr.Beast or MrBeast6000,2015-08-03T10:00:03Z,163279,4097,0,538,48,4635
503,How Much Youtube Money Do I Make???,2015-08-03T02:19:22Z,389219,9478,0,627,35,10105
504,Am I Ian From Smosh????,2015-08-02T19:09:03Z,780607,11085,0,561,23,11646
505,How Do You Turn Off A PS4? Xbox Noob In Need Of Help,2015-08-01T21:51:25Z,83072,1816,0,298,52,2114
506,"New Optic Gaming Gear Coming To Advanced Warfare, My Thoughts",2015-08-01T16:47:55Z,44901,1482,0,407,61,1889
507,Youtube Collabs? Collabbing with Mr.Beast?,2015-08-01T10:00:01Z,87723,1900,0,215,42,2115
508,Sacrifices And Youtube,2015-07-31T18:03:32Z,44862,2201,0,506,22,2707
509,5$ To Advertise Your Youtube Channel???,2015-07-31T00:13:08Z,137444,2726,0,273,39,2999
510,Reuploading Other Youtubers Videos? Stealing Big Youtubers Videos.,2015-07-30T18:23:18Z,44673,1199,0,197,66,1396
511,4k Subscriber's! First Channel Story!,2015-07-30T01:56:38Z,87871,2757,0,421,37,3178
512,People Who Got Rich From Movie Trailers On Youtube,2015-07-29T19:00:00Z,82185,1432,0,240,50,1672
513,Beast Gaming Set Up #almost4k,2015-07-29T15:31:24Z,70192,2131,0,383,29,2514
514,Advanced Warfare DLC 4 Honest Parody,2015-07-29T00:37:21Z,44690,1418,0,396,36,1814
515,World's Worst Thieves,2015-07-28T17:17:48Z,78014,1899,0,175,21,2074
516,VANOSSGAMING IS IN TROUBLE,2015-07-27T22:13:05Z,230702,3734,0,555,26,4289
517,SpiderMan Robs Walmart?????,2015-07-26T19:21:24Z,44662,1313,0,220,27,1533
518,My Upload For ThunderstruckGaming,2015-07-25T22:35:54Z,44675,1164,0,203,33,1367
519,Best FNAF 4 Fake Reactions! So Funny lol,2015-07-25T16:38:00Z,81410,2571,0,370,40,2941
520,How Many People Get The Diamond Play Button?????,2015-07-25T10:00:03Z,1776820,18075,0,2793,48,20868
521,Supply Drops For Charity! Ep #2,2015-07-24T10:00:00Z,45052,1796,0,851,31,2647
522,Best Thing To Happen To This Channel?????,2015-07-23T10:00:00Z,46001,1520,0,278,41,1798
523,Supply Drop Challenge For Charity,2015-07-22T17:59:43Z,44736,1892,0,571,33,2463
524,FaZe Clan Vs Pewdiepie Who Would Win?????,2015-07-21T18:51:04Z,54812,1097,0,160,41,1257
525,"FaZe Adapt ""Stuttertage""",2015-07-20T17:49:03Z,97637,2889,0,368,24,3257
526,The COD Community? Sleeping With Your Mom?,2015-07-19T17:37:51Z,44829,1505,0,402,42,1907
527,Exility And Some Other Stuff - Update Vid,2015-07-18T18:02:27Z,51217,11358,0,3362,41,14720
528,Every Minecraft Let's Play Ever In Under A Minute,2015-07-16T22:00:01Z,107517,3440,0,285,49,3725
529,Why I deleted Today's First Upload,2015-07-16T17:03:16Z,54036,1378,0,202,34,1580
530,What Is Spam404?????,2015-07-15T15:05:18Z,44652,1044,0,247,20,1291
531,The History Of Pewdiepie In 2 Minutes,2015-07-14T10:00:01Z,222918,6794,0,565,37,7359
532,TWITCH STREAMERS REACT TO RECEIVING THOUSANDS FROM SAME GUY!,2015-07-13T10:00:01Z,210831,2069,0,274,60,2343
533,I Hate Spam On Youtube,2015-07-12T19:08:52Z,44667,1552,0,466,22,2018
534,INSANE TRIPLE LEGENDARY SUPPLY DROP! BEST OPENING YET?,2015-07-11T20:08:50Z,47728,0,0,289,54,289
535,Low Bridge Causes Dozen's Of Wrecks! 11-8 Bridge,2015-07-10T21:56:20Z,45107,1848,0,480,48,2328
536,3k HYPE,2015-07-10T18:05:46Z,126409,3949,0,649,7,4598
537,How To Become A Gaming Youtuber! All You Need To Know!,2015-07-08T22:00:01Z,44666,1645,0,392,54,2037
538,My Solution For The Theft At The FaZe House - @FaZe_Rain @FaZeAdapt,2015-07-08T10:00:00Z,44798,1084,0,230,67,1314
539,5 Popular Channels That Were Terminated,2015-07-07T22:00:00Z,130941,4427,0,1061,39,5488
540,What Is Youtube Terms Of Service?????,2015-07-07T10:00:00Z,44654,1121,0,230,37,1351
541,Do You Think You Will Be Famous?????,2015-07-06T22:00:01Z,116656,2789,0,613,36,3402
542,What Is Swatting? Why I hate It!,2015-07-05T18:08:37Z,82062,2224,0,234,32,2458
543,Reddit Is In Chaos After Firing Victoria,2015-07-03T20:11:21Z,46007,953,0,169,40,1122
544,Paid Promotion On Youtube Good?,2015-07-03T19:26:09Z,45556,950,0,153,31,1103
545,How To Gain Youtube Success,2015-07-02T17:10:49Z,69675,2585,0,292,27,2877
546,FaZe Members Reaction's To Joining Faze,2015-07-01T19:56:45Z,576666,13320,0,693,39,14013
547,Battle of The Beasts Round 2 Winners!,2015-07-01T04:02:27Z,45168,1232,0,306,37,1538
548,Youtube In 10 Years?????,2015-06-30T16:31:29Z,161368,4212,0,1369,24,5581
549,The Ultimate Motivation For Small Youtubers,2015-06-29T17:27:21Z,248742,12715,0,1842,43,14557
550,How Much Does Pewdiepie Make?,2015-06-28T22:41:05Z,190880,2685,0,215,29,2900
551,Random Stuff You Don't Care About,2015-06-27T23:32:54Z,44951,1725,0,407,33,2132
552,Battle Of The Beast Round 1 Winners!,2015-06-23T19:49:57Z,44684,1229,0,220,36,1449
553,The Truth About Big Community Channels,2015-06-22T16:32:02Z,45081,1691,0,757,38,2448
554,WORLD'S FIRST BLACK OPS 3 GUN SYNC!!,2015-06-22T01:19:49Z,57524,1424,0,158,36,1582
555,Insane Gun Sync - 7 Hours To Make,2015-06-21T12:22:34Z,44821,1755,0,386,33,2141
556,Battle of The Beasts Bracket!!!! (Not accepting anymore),2015-06-20T03:32:30Z,44849,1199,0,245,56,1444
557,Free To Use Advanced Warfare Gameplay! 2015,2015-06-19T14:07:22Z,45044,1316,0,306,43,1622
558,Battle Of The Beast Tournament UPDATE!,2015-06-18T23:25:47Z,45787,1529,0,609,38,2138
559,My Top 5 Favorite Things At E3 2015,2015-06-18T17:18:38Z,44944,1395,0,369,35,1764
560,Battle Of The Beasts (youtubers needed),2015-06-17T20:58:19Z,44698,1188,0,285,39,1473
561,History Of COD Part 2! Black Ops 1 - History Of COD On Youtube!,2015-06-13T21:34:28Z,44696,1044,0,162,63,1206
562,How Did Notch Become A Billionaire? How Much Did Minecraft Sell For?????,2015-06-12T17:47:14Z,95923,2391,0,214,72,2605
563,Top 10 Richest Gaming Youtubers?????,2015-06-11T16:42:11Z,188751,5999,0,433,36,6432
564,Markiplier Is A Great Man! Sub shodleech!,2015-06-09T02:56:28Z,164435,1938,0,150,41,2088
565,Insane Advanced Warfare Hacker!,2015-06-07T22:58:31Z,44905,1435,0,287,31,1722
566,"What Is Considered A ""Bad Video"" On Youtube????? #karnageRC",2015-06-07T21:38:42Z,55156,1211,0,150,59,1361
567,I Think I Am Going For The #KarnageRC,2015-06-05T15:21:50Z,44687,1512,0,502,37,2014
568,Every FaZe Video Ever #karnageRC,2015-06-04T19:09:17Z,44902,1434,0,219,32,1653
569,How Much Money Do You Make As An Uber Driver??????,2015-05-31T18:31:25Z,44660,1074,0,183,50,1257
570,How Much Does Faze Rain's Giveaway Cost??????,2015-05-30T21:27:08Z,44650,1232,0,320,45,1552
571,MY MESSAGE TO COD YOUTUBERS (Watch till end plz),2015-05-29T20:07:48Z,44685,1210,0,255,48,1465
572,Best Of FlipArtz - His Best Advanced Supply Drops EVER!,2015-05-29T17:06:25Z,81412,1100,0,117,55,1217
573,Summer Is Finally Here!,2015-05-28T21:46:37Z,45296,1024,0,250,23,1274
574,Why Are Things Unbalanced In Video Games?????,2015-05-28T20:36:06Z,65130,1063,0,159,45,1222
575,New Channel?,2015-05-23T22:59:21Z,130987,3795,0,388,12,4183
576,"Youtube ""Freinds""",2015-05-23T01:28:10Z,75548,1328,0,197,17,1525
577,"Youtube Stat News - Vevo Gets 10 Bil. Views A Month, Channel Milestones, and more!",2015-05-21T00:31:22Z,45078,1937,0,719,82,2656
578,Big Changes??? Idk just watch the stupid video,2015-05-18T21:29:43Z,44692,1446,0,366,46,1812
579,How Much Money Does DramaAlert Make????,2015-05-15T23:53:16Z,44697,1547,0,320,39,1867
580,L0114R - Biblical Creeper Post for Post @L0114R,2015-05-15T16:48:54Z,45025,1023,0,236,47,1259
581,Why Do We Do Things That Are Bad For Us?????,2015-05-14T23:52:57Z,44682,1502,0,239,44,1741
582,How To Monetize Your Videos And Make Lots Of Youtube Money!!$$$,2015-05-10T20:59:50Z,44662,1358,0,323,63,1681
583,DIY $23.00 Mini Sound Booth? Does It Work?,2015-05-09T19:47:51Z,120030,2304,0,178,42,2482
584,Cut Coms vs Uncut Coms,2015-05-09T06:53:13Z,44716,1250,0,303,22,1553
585,Minimum Wage,2015-05-07T23:27:32Z,59194,1396,0,166,12,1562
586,My New Channel Trailer ;),2015-05-07T01:27:48Z,53138,1439,0,136,25,1575
587,Why I Changed My Channel Name,2015-05-03T23:59:54Z,120083,3189,0,332,29,3521
588,How Overpriced Is Movie Popcorn?????,2015-05-03T18:39:15Z,44679,1247,0,254,36,1501
589,Screw Warface,2015-05-02T21:41:18Z,44716,1193,0,221,13,1414
590,My Problems,2015-05-01T02:23:50Z,61045,1789,0,249,11,2038
591,Ma Channel,2015-04-29T23:50:00Z,44807,1354,0,253,10,1607
592,Remember When COD Was Fun?,2015-04-26T21:26:36Z,44709,1356,0,305,26,1661
593,My Baby Got a Virus :(,2015-04-25T22:34:19Z,66322,1463,0,222,22,1685
594,Modern Art Is A Joke,2015-04-25T15:02:30Z,44694,1210,0,221,20,1431
595,Cheat Channels,2015-04-24T01:53:38Z,44652,1328,0,346,14,1674
596,Time,2015-04-22T21:33:54Z,67210,1498,0,151,4,1649
597,"2,000 Subscribers",2015-04-18T18:45:34Z,248247,10591,0,2672,17,13263
598,Youtube,2015-04-14T22:39:24Z,74806,1875,0,218,7,2093
599,"How To SAT, Get Into Yale",2015-04-13T11:08:02Z,44686,1038,0,176,25,1214
600,100k Subs With No Videos????,2015-04-11T16:51:40Z,449635,8967,0,2858,28,11825
601,Is Jacksepticeye A Millionaire?????? 2016,2015-04-09T23:07:38Z,167702,3024,0,666,41,3690
602,How Rich Is Buzz Feed???,2015-04-07T11:16:50Z,51472,915,0,191,24,1106
603,How To Do A High School or College Paper!,2015-04-06T11:42:14Z,71862,1455,0,175,41,1630
604,What is Crohn's Disease?????,2015-04-04T20:31:25Z,469868,17565,0,1229,28,18794
605,What Happens If You Get A Copy Right Strike??,2015-04-03T19:45:11Z,162488,4258,0,551,45,4809
606,5 Steps To Becoming Successful On Youtube,2015-04-02T23:10:02Z,132497,6380,0,618,41,6998
607,Making Youtube a Priority,2015-04-01T23:58:35Z,50543,1437,0,203,25,1640
608,Why I Was Not Uploading,2015-03-21T22:11:51Z,46715,1079,0,184,23,1263
609,Youtubers Analytic's Explained,2015-03-06T01:07:06Z,48129,1227,0,158,30,1385
610,How Much $$$ Does Every Member of FaZe Make COMBINED????? 2016,2015-03-05T02:07:01Z,98846,1513,0,334,62,1847
611,Is Pewdiepie The #2 Youtuber?!?!?  :0,2015-03-04T01:53:50Z,71909,1527,0,303,37,1830
612,How Much Money Does Smosh Make????? 2016,2015-03-03T01:14:27Z,61320,1145,0,242,40,1387
613,Who Are The Worst Youtubers?????,2015-03-01T12:00:00Z,202732,3588,0,381,32,3969
614,Subscriber Goals For 2016,2015-02-28T17:12:07Z,46238,1252,0,553,25,1805
615,How Many People Do Youtube as a JOB?????,2015-02-26T02:07:13Z,44865,1192,0,220,40,1412
616,How Much Money Does Syndicate Project Make????? 2016,2015-02-24T20:26:12Z,64981,943,0,240,52,1183
617,Are Youtubers Millionaires?,2015-02-22T19:45:00Z,147280,2832,0,401,27,3233
618,Magecraft - Epic Hit! 11k Troops killed.,2015-02-21T15:41:14Z,44678,1159,0,284,40,1443
619,Highest Paid Musicians????,2015-02-17T21:38:06Z,100567,1700,0,266,26,1966
620,Making Fun Of Youtuber's Intros.,2015-02-16T19:45:42Z,306034,7415,0,619,32,8034
621,10 Things You DIDN'T Know About Youtube!,2015-02-08T00:04:06Z,57105,1345,0,154,40,1499
622,Quitting?,2015-02-06T22:27:38Z,115026,4286,0,647,9,4933
623,How Much Money Does Markiplier Make????? 2016,2015-01-04T20:59:46Z,106229,1866,0,225,45,2091
624,PewDiePie Uploads A Fake Video! LOL,2015-01-01T18:56:04Z,65587,1327,0,204,35,1531
625,Pewdiepie Was On T.V.,2014-12-07T17:51:08Z,127284,3197,0,399,21,3596
626,Five Facts You Didn't Know About Youtube.,2014-12-01T22:00:05Z,74677,1745,0,266,41,2011
627,Milestones And Plans For My Channel,2014-11-30T18:21:44Z,57747,1455,0,258,35,1713
628,How Much Money Did Gangnam Style Earn??? 2016,2014-11-26T22:53:11Z,83620,1673,0,230,45,1903
629,Best League Player In The Universe.,2014-11-23T17:37:28Z,311164,16927,0,1041,35,17968
630,MageCraft - Beginners tutorial. (The app),2014-11-17T02:25:46Z,44677,1059,0,201,41,1260
631,How much money does VanossGaming Make? 2016,2014-11-02T16:06:08Z,259540,3898,0,259,43,4157
632,Opening Old Basketball Cards! Ep. #1 (Michael Jordan Found),2014-10-21T02:19:05Z,142093,3252,0,281,59,3533
633,20 Best Websites?????,2014-08-29T22:45:20Z,130900,2720,0,424,21,3144
634,"How Much Money Does ""Chris Smooth"" Make?????",2014-08-21T22:46:35Z,54822,1044,0,175,44,1219
635,Money Problems,2014-08-20T17:40:18Z,221247,4347,0,378,14,4725
636,Vanoss vs Speedy! Who is better? Updated.,2014-08-20T01:57:30Z,44718,1262,0,365,41,1627
637,Welcome To My Channel!,2014-08-18T00:01:52Z,67433,1628,0,178,22,1806
638,1500,2014-08-08T18:58:18Z,245849,7645,0,1557,4,9202
639,How Much Money Does Yogscast Make????? 2016,2014-07-13T18:37:22Z,45439,832,0,161,43,993
640,How Much Does WhiteBoy7thSt Make????? 2016,2014-07-11T21:52:50Z,231509,2343,0,212,42,2555
641,"How Much Does ""Epic Rap Battles"" Make?????",2014-07-10T23:05:51Z,44660,1194,0,212,42,1406
642,How Much Money Does FaZe Make?????,2014-07-09T21:15:15Z,44704,1308,0,278,34,1586
643,"Top Youtube ""ShoutOuts""",2014-07-09T00:07:05Z,44659,1565,0,320,23,1885
644,Youtube Dream,2014-07-08T00:17:34Z,64098,1965,0,565,13,2530
645,In Dis Video I Play Minecraft. (Factions),2014-07-05T15:57:13Z,50577,1455,0,206,41,1661
646,Youtube Grind,2014-06-28T21:06:46Z,89476,2374,0,201,13,2575
647,Hacker in Ghost???? I Couldn't Kill Him.,2014-06-22T00:27:19Z,44780,1363,0,387,40,1750
648,How Much Money Does Tmartn Make?????,2014-06-21T18:43:51Z,45184,1395,0,346,36,1741
649,How Much Money Does FaZe Rain Make?????,2014-06-18T14:00:09Z,60524,1207,0,157,39,1364
650,G2g Brb,2014-06-16T14:00:07Z,44959,1420,0,398,7,1818
651,Crazy Nub Tub Reactions! Bo2 Fun!,2014-06-13T22:44:22Z,44881,1394,0,363,33,1757
652,Fun In COD. - Insane Reactions Lol,2014-06-10T19:01:43Z,44765,1405,0,371,34,1776
653,Minecraft Build-off Fun!!!!!,2014-06-09T12:00:07Z,62503,1715,0,212,28,1927
654,This Kid Should Quit COD....,2014-06-02T21:37:07Z,66994,1393,0,198,28,1591
655,Computer vs Console My Perspective.,2014-06-02T18:08:34Z,85700,1989,0,308,35,2297
656,5 Youtubers I Think Will Be Famous...,2014-05-31T21:06:55Z,193157,5067,0,848,37,5915
657,How Much Does PewDiePie Make????? 2016,2014-05-24T19:33:12Z,320599,5012,0,375,38,5387
658,I Got Really Really Really Bored....,2014-05-24T16:37:13Z,44780,1392,0,311,36,1703
659,How Much Money Does Penguinz0 Make????? 2016,2014-05-16T23:53:55Z,81315,2838,0,384,44,3222
660,How Much Money Does CaptainSparkles Make????? 2016,2014-05-15T20:36:54Z,523972,5597,0,487,50,6084
661,How Much Money Does Tobuscus Make?????,2014-05-14T23:06:58Z,54668,1192,0,229,38,1421
662,COD IS NOT DEAD,2014-05-08T02:19:42Z,61336,1937,0,302,15,2239
663,Storm,2014-04-30T20:31:15Z,199138,6311,0,815,5,7126
664,Hearthstone - All Beards Challenge!,2014-04-24T01:56:43Z,59902,1373,0,249,35,1622
665,Youtube ad.,2014-04-20T20:26:16Z,408098,8546,0,398,11,8944
666,Impossible,2014-04-20T01:45:45Z,68285,2264,0,351,10,2615
667,Motivation,2014-04-17T01:22:40Z,73559,2681,0,274,10,2955
668,1k Subs,2014-04-13T23:53:33Z,17286449,1281440,0,92489,7,1373929
669,Yup I is the best at the game.,2014-04-05T13:00:05Z,228745,4489,0,478,30,4967
670,Should I join FaZe?????,2014-04-04T19:44:52Z,701796,15072,0,1624,23,16696
671,"Youtube Networks Requirerments. (Machinima, TGN, 8byte....)",2014-04-01T16:37:55Z,74472,1124,0,182,59,1306
672,Two Years of Youtube.,2014-03-31T16:31:32Z,348299,8139,0,1000,21,9139
673,"How Much Money Does ""Element Animation"" Make?????",2014-03-30T23:40:18Z,143811,2736,0,322,49,3058
674,"How Much Money Does ""Skydoesminecraft"" Make????",2014-03-30T01:52:06Z,61612,1355,0,364,47,1719
675,Should College Athletes Be Paid?????,2014-03-29T00:18:35Z,69454,1622,0,287,36,1909
676,"""Beast"" Channel Trailer",2014-03-28T21:01:57Z,57057,1559,0,226,23,1785
677,What It Takes To Be A Full Time Youtuber...,2014-03-27T19:00:05Z,47313,1552,0,434,43,1986
678,How Video Games Boosted My SAT Score. Lol,2014-03-26T23:59:45Z,51367,1439,0,219,41,1658
679,How Much Money Do I Make?????,2014-03-16T01:24:25Z,133478,4338,0,655,29,4993
680,Update,2014-03-13T00:19:29Z,55164,1562,0,342,6,1904
681,Subscribers.,2014-03-08T03:52:13Z,93354,2797,0,1102,12,3899
682,How Much Money Does KyR's Speedy's Crew Make?????,2014-03-02T18:14:47Z,86969,1731,0,315,49,2046
683,How Many Youtubers Are Millionaries?????,2014-02-26T23:52:57Z,380903,7366,0,1538,40,8904
684,"Flappy Bird - Builders Showdown, Which is Better?",2014-02-23T22:29:21Z,97473,2736,0,421,49,3157
685,New COD Zombies In 2014?????,2014-02-23T21:40:04Z,68810,1848,0,337,28,2185
686,Minecraft Mansion Timelapse,2014-02-22T23:51:15Z,590660,19292,0,2344,27,21636
687,Top 5 NON-COPYRIGHTED Songs!!!!!,2014-02-17T20:30:02Z,104255,2999,0,561,32,3560
688,Vanoss vs Speedy! Which is better?,2014-02-16T20:13:22Z,102028,2382,0,925,34,3307
689,I Hate Pewdiepie!!!!!,2014-02-01T00:16:57Z,2899209,225649,0,15332,21,240981
690,Does Spam Work?????,2014-01-20T23:41:17Z,360282,6240,0,724,19,6964
691,100th VIDEO SPECIAL!,2014-01-20T01:17:01Z,352753,12428,0,1498,20,13926
692,The Vortex SMP Episode 1! Just Derping Around and Explaining Things.,2014-01-18T02:49:24Z,103998,3066,0,379,68,3445
693,Has Youtube Met Its Match?????,2014-01-12T01:25:53Z,78626,1849,0,273,30,2122
694,How Much Money Does Pewdiepie Make????? (Updated 2015),2014-01-11T20:31:34Z,1451976,24440,0,1910,54,26350
695,"Battle Pirates, my base.",2013-12-31T14:48:55Z,61453,1595,0,323,24,1918
696,"Battle Pirates, Hellstrike Base attack.",2013-12-29T22:22:57Z,55325,1551,0,327,39,1878
697,"Battle Pirates, Unstoppable Ship!",2013-12-29T21:05:08Z,46112,1851,0,712,33,2563
698,Best Hellstrike Build???? (Battle Pirates),2013-12-29T17:10:57Z,45943,1520,0,465,42,1985
699,"Marauder Builds, Battle Pirates In Depth Builds.",2013-12-29T16:20:05Z,45924,1813,0,632,48,2445
700,"Battle pirates, How To Auto Lvl 40 Salvages.",2013-12-29T00:32:15Z,47997,1620,0,426,44,2046
701,Hellstrikes vs 7 halos!,2013-12-27T00:27:31Z,64788,1587,0,344,23,1931
702,"Battle Pirates, Hellstrike vs Epic Base!",2013-12-24T00:00:20Z,55292,1604,0,365,40,1969
703,"Battle Pirates, Another Hellstrike Fail.",2013-12-18T23:47:57Z,55095,1628,0,354,40,1982
704,Battle pirates Hellstrike fail!,2013-12-18T22:31:02Z,55262,1593,0,328,31,1921
705,"Battle Pirates, lvl 66 vs Missile Cruiser x Fleet!",2013-12-17T18:56:41Z,57406,1570,0,296,50,1866
706,"Battle Pirates, Hellstrike Too Overpowered????",2013-12-14T15:58:11Z,55871,1620,0,296,46,1916
707,"Battle Pirates, All Sentinel Base.",2013-12-05T02:24:33Z,60377,1717,0,336,34,2053
708,"Battle pirates, Lvl 58 Mercury Base Attack!",2013-12-05T01:06:00Z,88028,2027,0,351,43,2378
709,"Battle Pirates, Stingray vs Mercury Epic Battle!",2013-12-05T00:00:24Z,58704,1939,0,427,48,2366
710,OpTiC NaDeShOt Got Hack!!,2013-11-27T19:37:44Z,64023,1896,0,448,25,2344
711,"Epic Ghost Multiplayer EasterEggs! (PrisonBreak, Sovereign, and Flooded)",2013-11-17T18:26:11Z,88066,2757,0,320,72,3077
712,Why Google Does Not Care What We Think....,2013-11-17T01:40:48Z,344980,6209,0,724,42,6933
713,My First Kem Strike!,2013-11-16T19:48:55Z,66897,2613,0,602,20,3215
714,Google+ The Death Of Youtube?????,2013-11-13T22:09:21Z,113797,2934,0,421,33,3355
715,How Much Money Does PewDiePie Make?????,2013-11-12T03:18:18Z,684501,13365,0,1293,39,14658
716,Most Overpowered Guns In Ghost!,2013-11-11T20:11:15Z,92624,3153,0,354,31,3507
717,Are Minecraft Faction Has A New Pet! (poopymiscquidlepants),2013-10-31T20:44:54Z,86761,2452,0,320,59,2772
718,Battle Pirates!,2013-09-21T22:18:59Z,88096,3288,0,699,15,3987
719,How To Duplicate Diamonds!!!!,2013-09-15T01:09:42Z,148436,5538,0,598,29,6136
720,50k Video Views!!!! EpicSauce!,2013-09-08T22:20:48Z,226451,8121,0,790,30,8911
721,If This Video Gets One Million Views.....,2013-09-07T02:28:05Z,12664241,1162891,0,75151,41,1238042
722,These Were The Good Days....,2013-09-05T02:14:46Z,135498,3853,0,413,28,4266
723,Channel Update.,2013-08-16T20:34:58Z,136481,3905,0,423,15,4328
724,Funny Noob Tubing Reaction Montage!,2013-08-16T03:04:45Z,100062,3059,0,517,35,3576
725,"Minecraft, How To Grief Without Being Seen!",2013-08-14T21:39:31Z,159546,5396,0,658,43,6054
726,Buried Round 50 Gameplay! Black ops 2 Zombies.,2013-08-12T22:49:16Z,106307,3599,0,455,46,4054
727,Minecraft Let's Play Ep. # 2 - Having Fun and Derping!,2013-08-12T01:53:18Z,158282,6525,0,843,54,7368
728,Worlds Biggest Ball Of TNT Minecraft!  Challenge Video!,2013-08-09T23:45:05Z,525576,17165,0,1587,55,18752
729,"How To Get A Gaming Partnership, And What It Is.",2013-08-08T21:25:32Z,75925,3016,0,591,48,3607
730,Camping Montage.... LOL,2013-08-05T21:12:41Z,82091,2949,0,488,23,3437
731,Black Ops 2! Mini Update Video.,2013-08-05T02:55:37Z,75615,3326,0,800,31,4126
732,Randomness,2013-08-02T22:16:42Z,75919,3455,0,884,10,4339
733,203 Kill Game! Thanks For 300 Subscribers!,2013-08-01T19:36:50Z,130458,5162,0,1016,42,6178
734,Call of Duty Ghost Multiplier Reveal Trailer Release Date!,2013-07-30T20:51:42Z,91575,3369,0,557,58,3926
735,Insane Black Ops 2 HACKER!!!!,2013-07-30T02:45:21Z,187004,5262,0,619,29,5881
736,Top Subscribed To Channels? BO2 w/ commentary!,2013-07-28T20:50:09Z,96914,3859,0,746,46,4605
737,Career Ender ....  LOL,2013-07-28T17:13:58Z,118695,3590,0,497,22,4087
738,I Bought A New Microphone!  (quality test),2013-07-27T23:25:01Z,128414,4312,0,573,42,4885
739,Top 10 Worst Guns in Call Of Duty History!,2013-07-25T21:36:56Z,171301,6480,0,655,42,7135
740,Black ops 2 Patch news!,2013-07-24T20:35:32Z,111048,4179,0,762,23,4941
741,Black ops 2 Invisible equipment and scorestreak glitch!,2013-07-21T18:26:36Z,135601,4596,0,574,55,5170
742,I'm Back! Update Video....,2013-07-19T23:41:14Z,154720,5769,0,683,26,6452
743,Minecraft Let's Play! Ep. 1. The Beginning!,2013-07-08T20:03:41Z,592729,21819,0,2501,43,24320
744,Channel Trailer....,2013-07-06T18:17:45Z,219539,8494,0,836,19,9330
745,Black ops 2 Shotgun gameplay w/ commentary....  Ps4 or Xbox?,2013-07-06T00:13:48Z,201313,5722,0,784,60,6506
746,Black ops 2 Gameplay w/ commentary. Hipsters,2013-07-03T17:48:10Z,286819,10425,0,899,44,11324
747,Project Zomboid Let's Play ep [04] lots of stuff,2013-06-18T15:51:26Z,110397,4782,0,891,48,5673
748,Project Zomboid Let's Play ep. [03] Looting and storing.,2013-06-17T02:17:34Z,108903,4679,0,1052,56,5731
749,Project Zomboid let's play ep. [02] Just some chores.,2013-06-15T19:54:37Z,109155,4876,0,877,53,5753
750,Project Zomboid Lets Play ep [01] Roughing it out!,2013-06-15T00:03:38Z,184110,7121,0,818,50,7939
751,Gunpowder plus mod! (Grenade mod) Epic explosions for minecraft.,2013-04-21T18:04:39Z,158832,6353,0,759,64,7112
752,Horse racing map for new update! (minecraft),2013-04-21T16:37:08Z,158402,6331,0,833,44,7164
753,Amazing minecraft Cathedral!,2013-04-21T01:36:32Z,317001,11354,0,1213,28,12567
754,Huge WW2 jeep! Minecraft creations.,2013-04-21T00:52:21Z,472795,15572,0,1827,35,17399
755,Story time!,2013-04-18T01:54:48Z,466909,17392,0,1547,11,18939
756,Epic Minecraft city! (w/ download link!),2013-04-11T01:00:01Z,288304,9475,0,1022,40,10497
757,Pokemon online battle #9 [rb] Hidden power ice ftw!,2013-04-07T00:03:02Z,144889,6397,0,761,51,7158
758,Pokemon online battle #8 Stone edge,2013-04-05T01:21:12Z,137943,7221,0,1523,35,8744
759,Online pokemon battle #7 [uu] 5-0,2013-04-04T01:43:46Z,184272,8635,0,904,33,9539
760,Magic karp sweeps whole team of LEGENDARIES!!!,2013-04-01T23:26:03Z,151584,6511,0,883,46,7394
761,Pokemon online battles #5 [uu] Heracross never seems to dissapoint me...,2013-03-31T20:49:28Z,146662,7355,0,1165,72,8520
762,This is a detailed break down of my favorite UU team... ENJOY!,2013-03-29T23:14:45Z,156653,7286,0,981,62,8267
763,Pokemon online battle #4 [uu] Same old team,2013-03-28T17:22:43Z,183786,0,0,1033,43,1033
764,Online pokemon battle #3 [uu] Ice punch,2013-03-27T19:57:08Z,157222,0,0,1366,39,1366
765,Pokemon online battle #2 [uu] Herracross w/ Dat MOXIE BOOST,2013-03-26T16:58:32Z,230341,0,0,1245,59,1245
766,Why I Haven't Been Uploading,2013-03-25T20:10:38Z,678215,0,0,1738,28,1738
767,Most Epic Thing In Minecraft!?!?!?!?!?!!?????,2013-03-10T22:19:14Z,351420,15000,0,1799,45,16799
768,Epic minecraft apartment complex!,2013-01-27T18:25:46Z,424168,18486,0,2112,33,20598
769,Crazy Illulsions In Minecraft. (Bigre),2013-01-27T02:11:30Z,587862,21735,0,2466,38,24201
770,Best Minecraft Castle Ever?,2013-01-27T01:52:40Z,316921,16433,0,2154,27,18587
771,How to get unlimited diamonds! minecraft (x-ray),2013-01-26T19:34:43Z,472632,21097,0,2038,48,23135
772,Drinks in minecraft (mod),2013-01-26T16:26:34Z,451059,0,0,1676,25,1676
773,Emerald tool mod! (minecraft),2013-01-23T22:34:58Z,436564,21602,0,2169,29,23771
774,This is a block? Since when lol.,2013-01-21T22:30:09Z,687684,28400,0,4145,32,32545
775,Scary minecraft pig skin!,2013-01-13T16:53:17Z,843888,31303,0,3102,25,34405
776,Most Epic minecraft skin EVER  (Psy),2013-01-13T01:59:21Z,926938,36185,0,3293,36,39478
777,More birds IN MINECRAFT!!,2013-01-12T23:35:45Z,1064446,41549,0,3582,25,45131
778,Boxy item mod Minecraft.  EPIC,2013-01-12T22:34:11Z,1255662,48896,0,4235,30,53131
779,Harry Potter Mod In Minecraft! EPIC MUST SEE MOD!!!,2012-03-09T23:29:03Z,4544641,0,0,8544,51,8544
780,Worst Minecraft Saw Trap Ever???,2012-02-20T22:42:32Z,22542250,1050354,0,120317,32,1170671
